+------+--------------+-------+
| SNO  | FLOORS       | PRICE |
+------+--------------+-------+
|    1 | FIRST FLOOR  |  1200 |
|    2 | SECOND FLOOR |  1800 |
|    3 | THIRD FLOOR  |  2500 |
+------+--------------+-------+
